apple - яблуко
book - книга
house - будинок
water - вода
sun - сонце
moon - місяць
star - зірка
tree - дерево
flower - квітка
city - місто
country - країна
people - люди
family - родина
friend - друг
time - час
day - день
night - ніч
year - рік
life - життя
love - любов
work - робота
school - школа
student - студент
teacher - вчитель
language - мова
word - слово
world - світ
sky - небо
earth - земля
sea - море
river - річка
mountain - гора
forest - ліс
animal - тварина
bird - птах
fish - риба
cat - кіт
dog - собака
food - їжа
bread - хліб
milk - молоко
coffee - кава
tea - чай
car - автомобіль
street - вулиця
home - дім
door - двері
window - вікно
table - стіл
chair - стілець